xtb	Aldur's Watchtower	Aldur's Advance
uul	Aldur's Watchtower	Aldur's Deception
9mt	Aldur's Watchtower	Aldur's Rhythm
dr8	Aldur's Watchtower	Aldur's Stony Gaze
rin	Angelic Raiment	Angelic Halo
rng	Angelic Raiment	Angelic Mantle
sbr	Angelic Raiment	Angelic Sickle
amu	Angelic Raiment	Angelic Wings
wst	Arcanna's Tricks	Arcanna's Deathwand
ltp	Arcanna's Tricks	Arcanna's Flesh
skp	Arcanna's Tricks	Arcanna's Head
amu	Arcanna's Tricks	Arcanna's Sign
vbl	Arctic Gear	Arctic Binding
qui	Arctic Gear	Arctic Furs
swb	Arctic Gear	Arctic Horn
tgl	Arctic Gear	Arctic Mitts
2ax	Berserker's Arsenal	Berserker's Hatchet
spl	Berserker's Arsenal	Berserker's Hauberk
hlm	Berserker's Arsenal	Berserker's Headgear
7gd	Bul-Kathos' Children	Bul-Kathos' Sacred Charge
7wd	Bul-Kathos' Children	Bul-Kathos' Tribal Guardian
chn	Cathan's Traps	Cathan's Mesh
bst	Cathan's Traps	Cathan's Rule
rin	Cathan's Traps	Cathan's Seal
amu	Cathan's Traps	Cathan's Sigil
msk	Cathan's Traps	Cathan's Visage
gsc	Civerb's Vestments	Civerb's Cudgel
amu	Civerb's Vestments	Civerb's Icon
lrg	Civerb's Vestments	Civerb's Ward
sml	Cleglaw's Brace	Cleglaw's Claw
mgl	Cleglaw's Brace	Cleglaw's Pincers
lsd	Cleglaw's Brace	Cleglaw's Tooth
stu	Cow King's Leathers	Cow King's Hide
vbt	Cow King's Leathers	Cow King's Hooves
xap	Cow King's Leathers	Cow King's Horns
lbl	Death's Disguise	Death's Guard
lgl	Death's Disguise	Death's Hand
wsd	Death's Disguise	Death's Touch
xar	Griswold's Legacy	Griswold's Heart
paf	Griswold's Legacy	Griswold's Honor
7ws	Griswold's Legacy	Griswold's Redemption
urn	Griswold's Legacy	Griswold's Valor
7ma	Heaven's Brethren	Dangoon's Teaching
xrs	Heaven's Brethren	Haemosu's Adamant
uhm	Heaven's Brethren	Ondal's Almighty
uts	Heaven's Brethren	Taebaek's Glory
buc	Hsarus' Defense	Hsarus' Iron Fist
mbt	Hsarus' Defense	Hsarus' Iron Heel
mbl	Hsarus' Defense	Hsarus' Iron Stay
mbl	Hwanin's Majesty	Hwanin's Blessing
9vo	Hwanin's Majesty	Hwanin's Justice
xcl	Hwanin's Majesty	Hwanin's Refuge
xrn	Hwanin's Majesty	Hwanin's Splendor
zhb	Immortal King	Immortal King's Detail
xhg	Immortal King	Immortal King's Forge
xhb	Immortal King	Immortal King's Pillar
uar	Immortal King	Immortal King's Soul Cage
7m7	Immortal King	Immortal King's Stone Crusher
ba5	Immortal King	Immortal King's Will
cap	Infernal Tools	Infernal Cranium
tbl	Infernal Tools	Infernal Sign
gwn	Infernal Tools	Infernal Torch
crn	Iratha's Finery	Iratha's Coil
amu	Iratha's Finery	Iratha's Collar
tbl	Iratha's Finery	Iratha's Cord
tgl	Iratha's Finery	Iratha's Cuff
brs	Isenhart's Armory	Isenhart's Case
fhl	Isenhart's Armory	Isenhart's Horns
bsd	Isenhart's Armory	Isenhart's Lightbrand
gts	Isenhart's Armory	Isenhart's Parry
amc	M'avina's Battle Hymn	M'avina's Caster
uld	M'avina's Battle Hymn	M'avina's Embrace
xtg	M'avina's Battle Hymn	M'avina's Icy Clutch
zvb	M'avina's Battle Hymn	M'avina's Tenet
ci3	M'avina's Battle Hymn	M'avina's True Sight
crn	Milabrega's Regalia	Milabrega's Diadem
kit	Milabrega's Regalia	Milabrega's Orb
aar	Milabrega's Regalia	Milabrega's Robe
wsp	Milabrega's Regalia	Milabrega's Rod
ci0	Naj's Ancient Vestige	Naj's Circlet
ult	Naj's Ancient Vestige	Naj's Light Plate
6cs	Naj's Ancient Vestige	Naj's Puzzler
7qr	Natalya's Odium	Natalya's Mark
ucl	Natalya's Odium	Natalya's Shadow
xmb	Natalya's Odium	Natalya's Soul
xh9	Natalya's Odium	Natalya's Totem
xhm	Orphan's Call	Guillaume's Face
xvg	Orphan's Call	Magnus' Skin
xml	Orphan's Call	Whitstan's Guard
ztb	Orphan's Call	Wilhelm's Pride
cap	Sander's Folly	Sander's Paragon
vbt	Sander's Folly	Sander's Riprap
bwn	Sander's Folly	Sander's Superstition
vgl	Sander's Folly	Sander's Taboo
7ls	Sazabi's Grand Tribute	Sazabi's Cobalt Redeemer
upl	Sazabi's Grand Tribute	Sazabi's Ghost Liberator
xhl	Sazabi's Grand Tribute	Sazabi's Mental Sheath
hgl	Sigon's Complete Steel	Sigon's Gage
tow	Sigon's Complete Steel	Sigon's Guard
hbt	Sigon's Complete Steel	Sigon's Sabot
gth	Sigon's Complete Steel	Sigon's Shelter
ghm	Sigon's Complete Steel	Sigon's Visor
hbl	Sigon's Complete Steel	Sigon's Wrap
amu	Tal Rasha's Wrappings	Tal Rasha's Adjudication
zmb	Tal Rasha's Wrappings	Tal Rasha's Fine-Spun Cloth
uth	Tal Rasha's Wrappings	Tal Rasha's Guardianship
xsk	Tal Rasha's Wrappings	Tal Rasha's Horadric Crest
oba	Tal Rasha's Wrappings	Tal Rasha's Lidless Eye
mpi	Tancred's Battlegear	Tancred's Crowbill
lbt	Tancred's Battlegear	Tancred's Hobnails
bhm	Tancred's Battlegear	Tancred's Skull
ful	Tancred's Battlegear	Tancred's Spine
amu	Tancred's Battlegear	Tancred's Weird
umc	The Disciple	Credendum
uui	The Disciple	Dark Adherent
ulg	The Disciple	Laying of Hands
xlb	The Disciple	Rite of Passage
amu	The Disciple	Telling of Beads
xmg	Trang-Oul's Avatar	Trang-Oul's Claws
utc	Trang-Oul's Avatar	Trang-Oul's Girth
uh9	Trang-Oul's Avatar	Trang-Oul's Guise
xul	Trang-Oul's Avatar	Trang-Oul's Scales
ne9	Trang-Oul's Avatar	Trang-Oul's Wing
lea	Vidala's Rig	Vidala's Ambush
lbb	Vidala's Rig	Vidala's Barb
tbt	Vidala's Rig	Vidala's Fetlock
amu	Vidala's Rig	Vidala's Snare
